"Time","MolarityNaF","Treatment","Group","Arms0","Arms1","Arms2","Total"
"2-48 h",0.002,"NaF","A",15,4,1,20
"2-48 h",0.002,"NaF","A",22,2,3,27
"2-48 h",0.002,"NaF","A",0,16,4,20
"2-48 h",0.002,"NaF","A",9,2,2,13
"2-48 h",0.002,"NaF","A",9,0,4,13
"2-48 h",0.002,"NaF","A",7,7,8,22
"2-48 h",0.002,"NaF","A",20,6,4,30
"2-48 h",0.002,"NaF","A",15,5,0,20
"2-48 h",0.002,"NaF","A",26,0,0,26
"2-48 h",0.002,"NaF","A",22,0,0,22
"2-48 h",0.002,"NaF","A",24,2,2,28
"2-48 h",0.002,"NaF","A",12,5,4,21
"2-48 h",0.002,"NaF","A",18,3,1,22
"2-48 h",0.002,"NaF","A",12,4,4,20
"2-48 h",0.002,"NaF","A",13,3,4,20
"2-48 h",0.002,"NaF","A",4,3,11,18
"2-48 h",0.002,"NaF","A",19,2,0,21
"2-48 h",0.002,"NaF","A",19,1,2,22
"2-48 h",0.002,"NaF","A",4,4,9,17
"2-48 h",0.002,"NaF","A",5,8,4,17
"2-48 h",0.002,"NaF","A",8,8,5,21
"2-48 h",0.004,"NaF","B",12,2,3,17
"2-48 h",0.004,"NaF","B",15,2,0,17
"2-48 h",0.004,"NaF","B",7,5,20,32
"2-48 h",0.004,"NaF","B",14,0,0,14
"2-48 h",0.004,"NaF","B",15,0,0,15
"2-48 h",0.004,"NaF","B",18,0,2,20
"2-48 h",0.004,"NaF","B",17,0,3,20
"2-48 h",0.004,"NaF","B",5,2,6,13
"2-48 h",0.004,"NaF","B",14,2,3,19
"2-48 h",0.004,"NaF","B",2,0,1,3
"2-48 h",0.004,"NaF","B",3,0,0,3
"2-48 h",0.004,"NaF","B",12,4,5,21
"2-48 h",0.004,"NaF","B",14,0,0,14
"2-48 h",0.004,"NaF","B",23,0,0,23
"2-48 h",0.004,"NaF","B",8,7,11,26
"2-48 h",0.004,"NaF","B",7,5,8,20
"2-48 h",0.004,"NaF","B",15,5,0,20
"2-48 h",0.004,"NaF","B",16,3,14,33
"2-48 h",0.004,"NaF","B",37,9,8,54
"2-48 h",0.004,"NaF","B",28,1,7,36
"2-48 h",0.004,"NaF","B",14,3,9,26
"24-48 h",0.002,"NaF","C",6,8,10,24
"24-48 h",0.002,"NaF","C",4,2,16,22
"24-48 h",0.002,"NaF","C",4,5,16,25
"24-48 h",0.002,"NaF","C",2,0,19,21
"24-48 h",0.002,"NaF","C",1,2,20,23
"24-48 h",0.002,"NaF","C",1,2,17,20
"24-48 h",0.002,"NaF","C",3,1,16,20
"24-48 h",0.002,"NaF","C",8,4,22,34
"24-48 h",0.002,"NaF","C",9,4,19,32
"24-48 h",0.002,"NaF","C",4,2,15,21
"24-48 h",0.002,"NaF","C",2,2,19,23
"24-48 h",0.002,"NaF","C",9,2,19,30
"24-48 h",0.002,"NaF","C",2,0,15,17
"24-48 h",0.002,"NaF","C",4,9,15,28
"24-48 h",0.002,"NaF","C",2,0,5,7
"24-48 h",0.002,"NaF","C",2,0,5,7
"24-48 h",0.004,"NaF","D",20,6,14,40
"24-48 h",0.004,"NaF","D",2,4,8,14
"24-48 h",0.004,"NaF","D",0,4,8,12
"24-48 h",0.004,"NaF","D",16,11,7,34
"24-48 h",0.004,"NaF","D",5,1,22,28
"24-48 h",0.004,"NaF","D",4,1,21,26
"24-48 h",0.004,"NaF","D",3,5,15,23
"24-48 h",0.004,"NaF","D",6,4,20,30
"24-48 h",0.004,"NaF","D",8,9,3,20
"24-48 h",0.004,"NaF","D",8,8,9,25
"24-48 h",0.004,"NaF","D",5,1,5,11
"24-48 h",0.004,"NaF","D",0,0,21,21
"24-48 h",0.004,"NaF","D",12,2,10,24
"24-48 h",0.004,"NaF","D",14,4,8,26
"24-48 h",0.004,"NaF","D",5,2,13,20
"24-48 h",0.004,"NaF","D",0,0,20,20
"24-48 h",0.004,"NaF","D",5,1,10,16
"24-48 h",0.004,"NaF","D",10,1,10,21
"24-48 h",0.004,"NaF","D",0,2,4,6
"24-48 h",0.004,"NaF","D",2,1,4,7
"24-48 h",0.004,"NaF","D",0,4,1,5
"2-24 h",0.002,"NaF","E",10,5,3,18
"2-24 h",0.002,"NaF","E",10,4,6,20
"2-24 h",0.002,"NaF","E",5,4,5,14
"2-24 h",0.002,"NaF","E",19,3,1,23
"2-24 h",0.002,"NaF","E",13,4,1,18
"2-24 h",0.002,"NaF","E",8,11,3,22
"2-24 h",0.002,"NaF","E",11,8,2,21
"2-24 h",0.002,"NaF","E",7,5,5,17
"2-24 h",0.002,"NaF","E",15,3,5,23
"2-24 h",0.002,"NaF","E",6,3,12,21
"2-24 h",0.002,"NaF","E",12,5,4,21
"2-24 h",0.002,"NaF","E",7,4,2,13
"2-24 h",0.002,"NaF","E",10,2,8,20
"2-24 h",0.002,"NaF","E",11,2,8,21
"2-24 h",0.002,"NaF","E",11,5,6,22
"2-24 h",0.002,"NaF","E",6,2,1,9
"2-24 h",0.002,"NaF","E",6,2,1,9
"2-24 h",0.002,"NaF","E",5,2,1,8
"2-24 h",0.002,"NaF","E",15,4,2,21
"2-24 h",0.004,"NaF","F",15,4,1,20
"2-24 h",0.004,"NaF","F",8,4,10,22
"2-24 h",0.004,"NaF","F",10,5,5,20
"2-24 h",0.004,"NaF","F",4,9,10,23
"2-24 h",0.004,"NaF","F",18,9,3,30
"2-24 h",0.004,"NaF","F",18,1,1,20
"2-24 h",0.004,"NaF","F",15,4,1,20
"2-24 h",0.004,"NaF","F",11,1,10,22
"2-24 h",0.004,"NaF","F",13,3,20,36
"2-24 h",0.004,"NaF","F",15,5,0,20
"2-24 h",0.004,"NaF","F",15,0,3,18
"2-24 h",0.004,"NaF","F",15,4,1,20
"2-24 h",0.004,"NaF","F",18,2,0,20
"2-24 h",0.004,"NaF","F",20,1,2,23
"2-24 h",0.004,"NaF","F",6,4,10,20
"2-24 h",0.004,"NaF","F",16,2,9,27
"2-24 h",0.004,"NaF","F",41,2,0,43
"2-24 h",0.004,"NaF","F",26,6,2,34
"Control",0,"Control","G",8,10,12,30
"Control",0,"Control","G",0,1,4,5
"Control",0,"Control","G",3,1,11,15
"Control",0,"Control","G",2,5,20,27
"Control",0,"Control","G",1,1,18,20
"Control",0,"Control","G",4,2,22,28
"Control",0,"Control","G",2,5,24,31
"Control",0,"Control","G",1,2,15,18
"Control",0,"Control","G",0,2,18,20
"Control",0,"Control","G",1,2,26,29
"Control",0,"Control","G",0,0,20,20
"Control",0,"Control","G",3,3,4,10
"Control",0,"Control","G",1,0,26,27
"Control",0,"Control","G",1,0,6,7
"Control",0,"Control","G",1,0,5,6
"Control",0,"Control","G",0,0,28,28
"Control",0,"Control","G",0,0,21,21
"Control",0,"Control","G",2,2,31,35
"Control",0,"Control","G",1,2,29,32
"Control",0,"Control","G",2,0,26,28
"Control",0,"Control","G",4,4,17,25
"Control",0,"Control","G",4,5,18,27
"Control",0,"Control","G",20,0,0,20
"Control",0,"Control","G",0,0,20,20
"Control",0,"Control","G",2,2,9,13
"Control",0,"Control","G",0,0,20,20
"Control",0,"Control","G",20,0,0,20
"Control",0,"Control","G",0,2,18,20
"Control",0,"Control","G",1,5,16,22
"Control",0,"Control","G",1,3,23,27
"Control",0,"Control","G",1,2,18,21
"Control",0,"Control","G",0,0,20,20
"Control",0,"Control","G",0,0,21,21
"Control",0,"Control","G",2,2,37,41
"Control",0,"Control","G",5,7,41,53
"Control",0,"Control","G",1,1,22,24
"Control",0,"Control","G",0,0,27,27
"Control",0,"Control","G",0,0,25,25
"Control",0,"Control","G",0,0,20,20
"Control",0,"Control","G",1,3,30,34
"Control",0,"Control","G",0,5,23,28
"Control",0,"Control","G",0,0,36,36
"Control",0,"Control","G",2,1,37,40
"Control",0,"Control","G",0,1,22,23
"Control",0,"Control","G",0,0,25,25
"Control",0,"Control","G",11,14,60,85
"Control",0,"Control","G",11,14,60,85
"Control",0,"Control","G",1,4,20,25
"Control",0,"Control","G",1,0,20,21
"Control",0,"Control","G",5,20,45,70
"Control",0,"Control","G",0,7,4,11
"Control",0,"Control","G",0,0,16,16
"Control",0,"Control","G",1,3,10,14
"Control",0,"Control","G",1,6,41,48
"Control",0,"Control","G",1,1,39,41
"Control",0,"Control","G",2,5,12,19
"Control",0,"Control","G",0,1,44,45
"Control",0,"Control","G",3,1,75,79
"Control",0,"Control","G",1,1,24,26
"Control",0,"Control","G",0,0,4,4
"Control",0,"Control","G",0,0,4,4
"Control",0,"Control","G",0,0,30,30
"Control",0,"Control","H",0,7,13,20
"Control",0,"Control","H",4,5,12,21
"Control",0,"Control","H",15,4,13,32
"Control",0,"Control","H",4,0,16,20
"Control",0,"Control","H",7,8,12,27
"Control",0,"Control","H",1,0,13,14
"Control",0,"Control","H",4,7,16,27
"Control",0,"Control","H",4,1,46,51
"Control",0,"Control","H",5,2,16,23
"Control",0,"Control","H",1,1,20,22
"Control",0,"Control","H",0,1,20,21
"Control",0,"Control","H",6,3,15,24
"Control",0,"Control","H",0,0,20,20
"Control",0,"Control","H",5,1,14,20
"Control",0,"Control","H",3,0,24,27
"Control",0,"Control","H",1,1,18,20
"Control",0,"Control","H",1,6,20,27
"Control",0,"Control","H",3,7,10,20
"Control",0,"Control","H",1,6,20,27
"Control",0,"Control","H",3,3,22,28
"Control",0,"Control","H",0,0,23,23
"Control",0,"Control","H",17,6,22,45
"Control",0,"Control","H",3,3,15,21
"Control",0,"Control","H",9,12,23,44
"Control",0,"Control","H",4,6,15,25
"Control",0,"Control","H",3,1,13,17
"Control",0,"Control","H",0,1,19,20
"Control",0,"Control","H",1,0,2,3
"Control",0,"Control","H",0,1,17,18
"Control",0,"Control","H",2,0,20,22
"Control",0,"Control","H",4,2,17,23
"Control",0,"Control","H",0,0,20,20
"Control",0,"Control","H",6,6,8,20
"Control",0,"Control","H",7,5,40,52
"Control",0,"Control","H",1,3,16,20
"Control",0,"Control","H",3,0,44,47
"Control",0,"Control","H",4,3,13,20
"Control",0,"Control","H",6,2,10,18
"Control",0,"Control","H",2,3,15,20
"Control",0,"Control","H",2,1,19,22
"Control",0,"Control","H",5,1,15,21
"Control",0,"Control","H",6,1,12,19
"Control",0,"Control","H",3,1,5,9
"Control",0,"Control","H",4,6,14,24
"Control",0,"Control","H",1,1,35,37
"Control",0,"Control","H",1,0,19,20
"Control",0,"Control","H",2,1,18,21
"Control",0,"Control","H",3,0,20,23
"Control",0,"Control","H",3,2,18,23
"Control",0,"Control","H",1,3,17,21
"Control",0,"Control","H",1,1,19,21
"Control",0,"Control","H",8,4,15,27
"Control",0,"Control","H",5,4,16,25
"Control",0,"Control","H",1,1,23,25
